"","X.1","X","Starts","Ends","Length","Copy_number","Strains","group"
"1",1,1,241,245,4,1.5,"SAMEA41278918",30
"2",2,2,2331,2381,50,3,"SAMEA41278918",7
"3",3,3,2268,2272,4,1.8,"SAMEA751451",7
"4",4,4,2358,2362,4,1.8,"SAMEA751451",7
"5",5,5,2373,2379,6,1.6,"SAMEA751451",7
"6",6,6,2389,2391,2,1.7,"SAMEA751451",7
"7",7,7,2394,2394,0,1.7,"SAMEA751451",7
"8",8,8,2398,2439,41,1.7,"SAMEA751451",7
"9",9,9,2441,2462,21,1.8,"SAMEA751451",7
"10",10,10,2466,2482,16,1.7,"SAMEA751451",31
"11",11,11,2487,2498,11,1.7,"SAMEA751451",32
"12",12,12,2500,2508,8,1.7,"SAMEA751451",33
"13",13,13,3288,3290,2,1.9,"SAMEA751451",3
"14",14,14,2269,2320,51,1.7,"SAMEA41276668",7
"15",15,15,2323,2330,7,1.6,"SAMEA41276668",7
"16",16,16,2347,2462,115,1.6,"SAMEA41276668",7
"17",17,17,649,654,5,1.3,"SAMEA41269918",9
"18",18,18,2331,2439,108,1.9,"SAMEA41269918",7
"19",19,19,3288,3290,2,2.1,"SAMEA41269918",3
"20",20,20,2276,2379,103,1.5,"SAMEA751508",7
"21",21,21,2381,2389,8,1.6,"SAMEA751508",7
"22",22,22,2396,2432,36,1.6,"SAMEA751508",7
"23",23,23,2750,2927,177,1.4,"SAMEA751508",17
"24",24,24,63,66,3,1.5,"SAMEA41323168",19
"25",25,25,2269,2320,51,1.7,"SAMEA41323168",7
"26",26,26,2323,2330,7,1.9,"SAMEA41323168",7
"27",27,27,2347,2372,25,1.9,"SAMEA41323168",7
"28",28,28,2389,2403,14,1.8,"SAMEA41323168",7
"29",29,29,2405,2409,4,1.8,"SAMEA41323168",7
"30",30,30,2289,2415,126,1.9,"SAMEA41247418",7
"31",31,31,2278,2366,88,2,"SAMEA751474",7
"32",32,32,2276,2432,156,1.8,"SAMEA41229418",7
"33",33,33,2286,2423,137,1.6,"SAMEA751181",7
"34",34,34,2237,2321,84,1.6,"SAMEA41228668",7
"35",35,35,2323,2431,108,1.7,"SAMEA41228668",7
"36",36,36,367,392,25,1.3,"SAMEA751142",34
"37",37,37,394,432,38,1.3,"SAMEA751142",22
"38",38,38,445,494,49,1.3,"SAMEA751142",29
"39",39,39,2358,2362,4,1.9,"SAMEA751142",7
"40",40,40,2373,2379,6,1.6,"SAMEA751142",7
"41",41,41,2389,2391,2,1.7,"SAMEA751142",7
"42",42,42,2394,2394,0,1.8,"SAMEA751142",7
"43",43,43,2398,2401,3,1.7,"SAMEA751142",7
"44",44,44,2405,2423,18,1.7,"SAMEA751142",7
"45",45,45,2425,2429,4,1.8,"SAMEA751142",7
"46",46,46,3275,3276,1,1.5,"SAMEA751142",35
"47",47,47,2234,2379,145,1.8,"SAMEA41232418",7
"48",48,48,2417,2440,23,1.8,"SAMEA41232418",7
"49",49,49,2243,2364,121,1.8,"SAMEA104210866",7
"50",50,50,2243,2314,71,1.6,"SAMEA41260918",7
"51",51,51,2316,2342,26,1.6,"SAMEA41260918",7
"52",52,52,2244,2379,135,1.7,"SAMEA41261668",7
"53",53,53,2331,2362,31,2.1,"SAMEA104210860",7
"54",54,54,2321,2382,61,1.3,"SAMEA41227168",7
"55",55,55,2243,2314,71,1.3,"SAMEA41233918",7
"56",56,56,2316,2346,30,1.3,"SAMEA41233918",7
"57",57,57,2243,2403,160,1.3,"SAMEA41250418",7
"58",58,58,2247,2362,115,1.3,"SAMEA41257168",7
"59",59,59,2261,2358,97,1.7,"SAMEA41245168",7
"60",60,60,2292,2382,90,1.8,"SAMEA104210813",7
"61",61,61,2269,2388,119,2.6,"SAMEA751394",7
"62",62,62,1029,1075,46,1.9,"SAMEA751140",23
"63",63,63,2269,2384,115,2,"SAMEA751140",7
"64",64,64,2269,2276,7,1.9,"SAMEA104210823",7
"65",65,65,2278,2388,110,1.9,"SAMEA104210823",7
"66",66,66,1338,1454,116,1.8,"SAMEA41234668",20
"67",67,67,2236,2314,78,1.9,"SAMEA41234668",7
"68",68,68,2316,2440,124,1.9,"SAMEA41234668",7
"69",69,69,1338,1340,2,1.4,"SAMEA41322418",20
"70",70,70,2105,2113,8,1.8,"SAMEA41322418",7
"71",71,71,2126,2222,96,1.9,"SAMEA41322418",7
"72",72,72,2240,2276,36,1.9,"SAMEA41322418",7
"73",73,73,2278,2320,42,1.9,"SAMEA41322418",7
"74",74,74,2323,2330,7,1.9,"SAMEA41322418",7
"75",75,75,2347,2357,10,2,"SAMEA41322418",7
"76",76,76,2373,2388,15,1.8,"SAMEA41322418",7
"77",77,77,3356,3571,215,1.9,"SAMEA41279668",2
"78",78,78,3573,3653,80,1.9,"SAMEA41279668",16
"79",79,79,1966,1979,13,4,"SAMEA41231668",15
"80",80,80,1791,1965,174,1.8,"SAMEA751489",10
"81",81,81,1021,1111,90,1.6,"SAMEA41243668",23
"82",82,82,2752,2907,155,1.5,"SAMEA41243668",17
"83",83,83,2830,2869,39,1.8,"SAMEA41236918",17
"84",84,84,2830,2839,9,1.8,"SAMEA41319418",17
"85",85,85,2830,2866,36,1.9,"SAMEA41244418",17
"86",86,86,2830,2866,36,1.9,"SAMEA41251168",17
"87",87,87,2840,2900,60,1.7,"SAMEA41245918",17
"88",88,88,2830,2907,77,1.6,"SAMEA41316418",17
"89",89,89,2830,2908,78,1.7,"SAMEA41269168",17
"90",90,90,2910,2922,12,1.6,"SAMEA41269168",17
"91",91,91,2835,2921,86,1.6,"SAMEA751424",17
"92",92,92,2839,2914,75,1.7,"SAMN08443767",17
"93",93,93,2798,2914,116,1.3,"SAMEA41252668",17
"94",94,94,742,747,5,1.3,"SAMEA104210853",4
"95",95,95,1020,1051,31,1.3,"SAMEA104210853",23
"96",96,96,2830,2941,111,1.5,"SAMEA104210853",17
"97",97,97,1090,1109,19,1.6,"SAMEA41282668",23
"98",98,98,2750,3027,277,1.6,"SAMEA41282668",17
"99",99,99,2798,2914,116,1.8,"SAMEA104210861",17
"100",100,100,58,67,9,1.6,"SAMEA41254918",19
"101",101,101,1705,1708,3,1.3,"SAMEA41254918",6
"102",102,102,2098,2103,5,1.3,"SAMEA41254918",5
"103",103,103,2752,2755,3,1.7,"SAMEA41254918",17
"104",104,104,2788,2922,134,1.9,"SAMEA41254918",17
"105",105,105,2752,2900,148,1.7,"SAMEA751323",17
"106",106,106,58,69,11,1.4,"SAMEA41321668",19
"107",107,107,2752,2786,34,1.5,"SAMEA41321668",17
"108",108,108,2799,2907,108,1.7,"SAMEA41321668",17
"109",109,109,2910,2914,4,1.7,"SAMEA41321668",17
"110",110,110,778,827,49,2.4,"SAMEA751182",13
"111",111,111,779,840,61,1.8,"SAMEA41281918",13
"112",112,112,842,850,8,1.9,"SAMEA41281918",13
"113",113,113,859,864,5,1.8,"SAMEA41281918",13
"114",114,114,905,911,6,1.6,"SAMEA41281918",13
"115",115,115,917,963,46,1.7,"SAMEA41281918",13
"116",116,116,779,967,188,1.8,"SAMEA41294668",13
"117",117,117,3288,3290,2,1.9,"SAMEA41242168",3
"118",118,118,3621,3664,43,2.4,"SAMEA41242168",16
"119",119,119,3288,3290,2,2,"SAMEA41240668",3
"120",120,120,3626,3653,27,2.9,"SAMEA41240668",16
"121",121,121,3288,3290,2,1.9,"SAMEA41241418",3
"122",122,122,3626,3652,26,2,"SAMEA41241418",16
"123",123,123,3288,3290,2,1.8,"SAMEA41242918",3
"124",124,124,3626,3652,26,1.7,"SAMEA41242918",16
"125",125,125,742,747,5,1.3,"SAMEA41206918",4
"126",126,126,1296,1304,8,1.6,"SAMEA41206918",36
"127",127,127,1309,1310,1,1.7,"SAMEA41206918",20
"128",128,128,1313,1338,25,1.6,"SAMEA41206918",20
"129",129,129,1341,1397,56,1.6,"SAMEA41206918",20
"130",130,130,1399,1454,55,1.5,"SAMEA41206918",20
"131",131,131,742,746,4,1.4,"SAMEA41284168",4
"132",132,132,2052,2071,19,1.6,"SAMEA41284168",11
"133",133,133,742,747,5,1.3,"SAMN02263896",4
"134",134,134,779,806,27,1.7,"SAMN02263896",13
"135",135,135,2100,2103,3,1.4,"SAMN02263896",5
"136",136,136,2134,2140,6,1.4,"SAMN02263896",7
"137",137,137,2142,2152,10,1.3,"SAMN02263896",7
"138",138,138,3288,3290,2,1.7,"SAMN02263896",3
"139",139,139,276,279,3,1.8,"SAMN08443759",28
"140",140,140,1310,1312,2,2.2,"SAMN08443759",20
"141",141,141,1773,1777,4,1.9,"SAMN08443759",12
"142",142,142,1790,1791,1,1.9,"SAMN08443759",10
"143",143,143,1827,1828,1,2,"SAMN08443759",10
"144",144,144,2057,2059,2,2.2,"SAMN08443759",11
"145",145,145,3288,3290,2,2.2,"SAMN08443759",3
"146",146,146,3288,3290,2,1.9,"SAMEA41236168",3
"147",147,147,742,746,4,1.4,"SAMN07352197",4
"148",148,148,1705,1708,3,1.4,"SAMN07352197",6
"149",149,149,2099,2103,4,1.4,"SAMN07352197",5
"150",150,150,3288,3290,2,1.8,"SAMN07352197",3
"151",151,151,742,747,5,1.3,"SAMEA2269771",4
"152",152,152,742,746,4,1.4,"SAMEA1931537",4
"153",153,153,2100,2103,3,1.4,"SAMEA1931537",5
"154",154,154,3288,3290,2,2,"SAMEA751513",3
"155",155,155,742,747,5,1.4,"SAMN02263946",4
"156",156,156,1705,1708,3,1.3,"SAMN02263946",6
"157",157,157,2099,2103,4,1.4,"SAMN02263946",5
"158",158,158,3288,3290,2,1.6,"SAMN02263946",3
"159",159,159,742,747,5,1.3,"SAMEA2401058",4
"160",160,160,1705,1708,3,1.3,"SAMEA2401058",6
"161",161,161,2099,2103,4,1.3,"SAMEA2401058",5
"162",162,162,3288,3289,1,1.9,"SAMEA2401058",3
"163",163,163,3288,3290,2,2,"SAMEA751144",3
"164",164,164,742,747,5,1.4,"SAMN07329770",4
"165",165,165,2098,2103,5,1.3,"SAMN07329770",5
"166",166,166,63,69,6,1.3,"SAMEA2177731",19
"167",167,167,742,746,4,1.5,"SAMEA2177731",4
"168",168,168,1705,1708,3,1.4,"SAMEA2177731",6
"169",169,169,2099,2103,4,1.4,"SAMEA2177731",5
"170",170,170,3288,3289,1,1.8,"SAMEA2177731",3
"171",171,171,3384,3388,4,1.3,"SAMEA2177731",2
"172",172,172,63,69,6,1.3,"SAMN06140502",19
"173",173,173,742,746,4,1.4,"SAMN06140502",4
"174",174,174,2100,2103,3,1.4,"SAMN06140502",5
"175",175,175,742,746,4,1.4,"SAMN03455372",4
"176",176,176,1705,1708,3,1.4,"SAMN03455372",6
"177",177,177,2099,2103,4,1.5,"SAMN03455372",5
"178",178,178,3350,3357,7,1.3,"SAMN03455372",2
"179",179,179,742,747,5,1.3,"SAMN03455360",4
"180",180,180,1705,1708,3,1.4,"SAMN03455360",6
"181",181,181,2099,2103,4,1.4,"SAMN03455360",5
"182",182,182,742,747,5,1.4,"SAMN03702669",4
"183",183,183,1705,1708,3,1.3,"SAMN03702669",6
"184",184,184,2098,2103,5,1.3,"SAMN03702669",5
"185",185,185,59,70,11,1.3,"SAMN07352226",19
"186",186,186,742,746,4,1.5,"SAMN07352226",4
"187",187,187,1705,1708,3,1.4,"SAMN07352226",6
"188",188,188,2100,2103,3,1.5,"SAMN07352226",5
"189",189,189,3288,3290,2,1.7,"SAMN07352226",3
"190",190,190,742,747,5,1.4,"SAMN04383586",4
"191",191,191,1705,1708,3,1.4,"SAMN04383586",6
"192",192,192,2098,2103,5,1.3,"SAMN04383586",5
"193",193,193,3288,3289,1,1.8,"SAMN04383586",3
"194",194,194,742,747,5,1.5,"SAMN04221180",4
"195",195,195,1705,1708,3,1.4,"SAMN04221180",6
"196",196,196,2100,2103,3,1.5,"SAMN04221180",5
"197",197,197,3288,3289,1,1.8,"SAMN04221180",3
"198",198,198,59,70,11,1.3,"SAMN02231527",19
"199",199,199,742,747,5,1.3,"SAMN02231527",4
"200",200,200,2099,2103,4,1.4,"SAMN02231527",5
"201",201,201,3288,3289,1,1.8,"SAMN02231527",3
"202",202,202,63,70,7,1.3,"SAMN04383602",19
"203",203,203,742,746,4,1.4,"SAMN04383602",4
"204",204,204,1705,1708,3,1.4,"SAMN04383602",6
"205",205,205,2099,2103,4,1.4,"SAMN04383602",5
"206",206,206,3288,3290,2,1.6,"SAMN04383602",3
"207",207,207,3351,3356,5,1.3,"SAMN04383602",2
"208",208,208,742,747,5,1.4,"SAMN03249379",4
"209",209,209,1705,1708,3,1.3,"SAMN03249379",6
"210",210,210,2099,2103,4,1.5,"SAMN03249379",5
"211",211,211,742,746,4,1.4,"SAMEA41186668",4
"212",212,212,1705,1708,3,1.4,"SAMEA41186668",6
"213",213,213,2100,2103,3,1.4,"SAMEA41186668",5
"214",214,214,742,746,4,1.4,"SAMN07329767",4
"215",215,215,2099,2103,4,1.4,"SAMN07329767",5
"216",216,216,742,746,4,1.3,"SAMN07329781",4
"217",217,217,2100,2103,3,1.3,"SAMN07329781",5
"218",218,218,742,746,4,1.4,"SAMN07326325",4
"219",219,219,2099,2103,4,1.3,"SAMN07326325",5
"220",220,220,3285,3290,5,1.5,"SAMN07326325",3
"221",221,221,742,746,4,1.4,"SAMN03466640",4
"222",222,222,1705,1708,3,1.3,"SAMN03466640",6
"223",223,223,2099,2103,4,1.4,"SAMN03466640",5
"224",224,224,3288,3289,1,1.8,"SAMN03466640",3
"225",225,225,742,747,5,1.4,"SAMN07329780",4
"226",226,226,2099,2103,4,1.3,"SAMN07329780",5
"227",227,227,3288,3289,1,1.7,"SAMN07329780",3
"228",228,228,653,663,10,1.3,"SAMN03455339",9
"229",229,229,742,747,5,1.4,"SAMN03455339",4
"230",230,230,2099,2103,4,1.4,"SAMN03455339",5
"231",231,231,3288,3290,2,1.7,"SAMN03455339",3
"232",232,232,3384,3388,4,1.3,"SAMN03455339",2
"233",233,233,656,662,6,1.3,"SAMN07329779",9
"234",234,234,742,747,5,1.3,"SAMN07329779",4
"235",235,235,1705,1708,3,1.3,"SAMN07329779",6
"236",236,236,2099,2103,4,1.3,"SAMN07329779",5
"237",237,237,3288,3290,2,1.8,"SAMN07329779",3
"238",238,238,654,662,8,1.3,"SAMN07352198",9
"239",239,239,742,747,5,1.3,"SAMN07352198",4
"240",240,240,1705,1708,3,1.3,"SAMN07352198",6
"241",241,241,2099,2103,4,1.4,"SAMN07352198",5
"242",242,242,3288,3290,2,1.8,"SAMN07352198",3
"243",243,243,742,747,5,1.3,"SAMN02231455",4
"244",244,244,1705,1708,3,1.4,"SAMN02231455",6
"245",245,245,2099,2103,4,1.4,"SAMN02231455",5
"246",246,246,3288,3291,3,1.7,"SAMN02231455",3
"247",247,247,742,746,4,1.4,"SAMN02231459",4
"248",248,248,1705,1708,3,1.3,"SAMN02231459",6
"249",249,249,2099,2103,4,1.3,"SAMN02231459",5
"250",250,250,3288,3291,3,1.7,"SAMN02231459",3
"251",251,251,742,746,4,1.4,"SAMN07329790",4
"252",252,252,1705,1708,3,1.4,"SAMN07329790",6
"253",253,253,2099,2103,4,1.4,"SAMN07329790",5
"254",254,254,3288,3290,2,1.7,"SAMN07329790",3
"255",255,255,742,746,4,1.3,"SAMN02231458",4
"256",256,256,1705,1708,3,1.3,"SAMN02231458",6
"257",257,257,2099,2103,4,1.3,"SAMN02231458",5
"258",258,258,3288,3290,2,1.8,"SAMN02231458",3
"259",259,259,742,746,4,1.3,"SAMN07352195",4
"260",260,260,1705,1708,3,1.3,"SAMN07352195",6
"261",261,261,2099,2103,4,1.3,"SAMN07352195",5
"262",262,262,3288,3290,2,1.9,"SAMN07352195",3
"263",263,263,742,746,4,1.5,"SAMN07352190",4
"264",264,264,1705,1708,3,1.4,"SAMN07352190",6
"265",265,265,2099,2103,4,1.4,"SAMN07352190",5
"266",266,266,3288,3290,2,1.8,"SAMN07352190",3
"267",267,267,742,747,5,1.3,"SAMEA41190418",4
"268",268,268,1705,1708,3,1.3,"SAMEA41190418",6
"269",269,269,2099,2103,4,1.3,"SAMEA41190418",5
"270",270,270,3288,3290,2,1.9,"SAMEA41190418",3
"271",271,271,742,747,5,1.3,"SAMEA41200918",4
"272",272,272,1705,1708,3,1.3,"SAMEA41200918",6
"273",273,273,2099,2103,4,1.3,"SAMEA41200918",5
"274",274,274,3288,3290,2,1.8,"SAMEA41200918",3
"275",275,275,742,747,5,1.3,"SAMEA1570040",4
"276",276,276,2099,2103,4,1.3,"SAMEA1570040",5
"277",277,277,3287,3290,3,1.8,"SAMEA1570040",3
"278",278,278,742,747,5,1.4,"SAMEA1931450",4
"279",279,279,2099,2103,4,1.3,"SAMEA1931450",5
"280",280,280,3288,3290,2,1.8,"SAMEA1931450",3
"281",281,281,742,746,4,1.4,"SAMN06140500",4
"282",282,282,2100,2103,3,1.4,"SAMN06140500",5
"283",283,283,3288,3290,2,1.7,"SAMN06140500",3
"284",284,284,742,746,4,1.4,"SAMN03455370",4
"285",285,285,2099,2103,4,1.4,"SAMN03455370",5
"286",286,286,3288,3290,2,1.8,"SAMN03455370",3
"287",287,287,742,747,5,1.3,"SAMEA41188918",4
"288",288,288,2099,2103,4,1.3,"SAMEA41188918",5
"289",289,289,3288,3290,2,1.8,"SAMEA41188918",3
"290",290,290,742,747,5,1.3,"SAMN02263924",4
"291",291,291,1705,1708,3,1.4,"SAMN02263924",6
"292",292,292,2099,2103,4,1.4,"SAMN02263924",5
"293",293,293,3288,3289,1,1.8,"SAMN02263924",3
"294",294,294,742,747,5,1.3,"SAMN02263944",4
"295",295,295,1705,1708,3,1.3,"SAMN02263944",6
"296",296,296,2099,2103,4,1.4,"SAMN02263944",5
"297",297,297,3288,3291,3,1.7,"SAMN02263944",3
"298",298,298,742,746,4,1.4,"SAMEA2177730",4
"299",299,299,1705,1708,3,1.3,"SAMEA2177730",6
"300",300,300,2099,2103,4,1.4,"SAMEA2177730",5
"301",301,301,3288,3290,2,1.8,"SAMEA2177730",3
"302",302,302,742,747,5,1.4,"SAMN07352224",4
"303",303,303,2099,2103,4,1.4,"SAMN07352224",5
"304",304,304,3288,3290,2,1.7,"SAMN07352224",3
"305",305,305,742,746,4,1.4,"SAMN03455368",4
"306",306,306,2099,2103,4,1.4,"SAMN03455368",5
"307",307,307,3288,3290,2,1.8,"SAMN03455368",3
"308",308,308,742,746,4,1.4,"SAMEA2177726",4
"309",309,309,1705,1708,3,1.4,"SAMEA2177726",6
"310",310,310,2099,2103,4,1.5,"SAMEA2177726",5
"311",311,311,3288,3290,2,1.8,"SAMEA2177726",3
"312",312,312,742,746,4,1.3,"SAMN03455354",4
"313",313,313,1705,1708,3,1.3,"SAMN03455354",6
"314",314,314,2100,2103,3,1.4,"SAMN03455354",5
"315",315,315,3288,3290,2,1.7,"SAMN03455354",3
"316",316,316,742,747,5,1.4,"SAMN02263943",4
"317",317,317,1705,1708,3,1.4,"SAMN02263943",6
"318",318,318,2099,2103,4,1.4,"SAMN02263943",5
"319",319,319,3288,3290,2,1.8,"SAMN02263943",3
"320",320,320,742,747,5,1.3,"SAMEA2177727",4
"321",321,321,1705,1708,3,1.4,"SAMEA2177727",6
"322",322,322,2099,2103,4,1.4,"SAMEA2177727",5
"323",323,323,3288,3290,2,1.8,"SAMEA2177727",3
"324",324,324,742,747,5,1.3,"SAMEA41188168",4
"325",325,325,1705,1708,3,1.3,"SAMEA41188168",6
"326",326,326,2099,2103,4,1.3,"SAMEA41188168",5
"327",327,327,3288,3290,2,1.8,"SAMEA41188168",3
"328",328,328,742,747,5,1.3,"SAMEA41200168",4
"329",329,329,1705,1708,3,1.3,"SAMEA41200168",6
"330",330,330,2099,2103,4,1.3,"SAMEA41200168",5
"331",331,331,3288,3290,2,1.8,"SAMEA41200168",3
"332",332,332,742,746,4,1.4,"SAMN07329775",4
"333",333,333,2099,2103,4,1.3,"SAMN07329775",5
"334",334,334,3288,3290,2,1.7,"SAMN07329775",3
"335",335,335,742,746,4,1.3,"SAMN05333714",4
"336",336,336,2099,2103,4,1.3,"SAMN05333714",5
"337",337,337,3288,3290,2,1.8,"SAMN05333714",3
"338",338,338,742,747,5,1.4,"SAMEA3871515",4
"339",339,339,2099,2103,4,1.4,"SAMEA3871515",5
"340",340,340,3287,3290,3,1.6,"SAMEA3871515",3
"341",341,341,742,747,5,1.4,"SAMN02940632",4
"342",342,342,2099,2103,4,1.4,"SAMN02940632",5
"343",343,343,3288,3290,2,1.7,"SAMN02940632",3
"344",344,344,742,747,5,1.4,"SAMN03167927",4
"345",345,345,2099,2103,4,1.4,"SAMN03167927",5
"346",346,346,3288,3290,2,1.7,"SAMN03167927",3
"347",347,347,742,746,4,1.4,"SAMEA2177729",4
"348",348,348,2100,2103,3,1.4,"SAMEA2177729",5
"349",349,349,3288,3290,2,1.8,"SAMEA2177729",3
"350",350,350,742,746,4,1.4,"SAMN05333716",4
"351",351,351,2099,2103,4,1.4,"SAMN05333716",5
"352",352,352,3288,3290,2,1.8,"SAMN05333716",3
"353",353,353,742,747,5,1.3,"SAMEA1570037",4
"354",354,354,2099,2103,4,1.3,"SAMEA1570037",5
"355",355,355,3288,3290,2,1.9,"SAMEA1570037",3
"356",356,356,742,747,5,1.3,"SAMN02231288",4
"357",357,357,2100,2103,3,1.4,"SAMN02231288",5
"358",358,358,3288,3290,2,1.7,"SAMN02231288",3
"359",359,359,742,746,4,1.3,"SAMEA2060425",4
"360",360,360,3288,3289,1,1.9,"SAMEA2060425",3
"361",361,361,742,747,5,1.3,"SAMN02231528",4
"362",362,362,1705,1708,3,1.3,"SAMN02231528",6
"363",363,363,3288,3291,3,1.8,"SAMN02231528",3
"364",364,364,742,747,5,1.3,"SAMEA1931748",4
"365",365,365,1705,1708,3,1.3,"SAMEA1931748",6
"366",366,366,3288,3290,2,1.8,"SAMEA1931748",3
"367",367,367,742,747,5,1.3,"SAMN02263947",4
"368",368,368,1705,1708,3,1.3,"SAMN02263947",6
"369",369,369,2099,2103,4,1.3,"SAMN02263947",5
"370",370,370,3288,3291,3,1.8,"SAMN02263947",3
"371",371,371,742,746,4,1.4,"SAMN02263895",4
"372",372,372,1705,1708,3,1.4,"SAMN02263895",6
"373",373,373,2099,2103,4,1.4,"SAMN02263895",5
"374",374,374,3288,3291,3,1.6,"SAMN02263895",3
"375",375,375,742,746,4,1.3,"SAMN05751702",4
"376",376,376,1705,1708,3,1.3,"SAMN05751702",6
"377",377,377,2100,2103,3,1.3,"SAMN05751702",5
"378",378,378,3288,3291,3,1.8,"SAMN05751702",3
"379",379,379,58,68,10,1.5,"SAMEA41308918",19
"380",380,380,2099,2103,4,1.4,"SAMEA41308918",5
"381",381,381,2099,2103,4,1.4,"SAMN06140509",5
"382",382,382,742,746,4,1.4,"SAMN07352199",4
"383",383,383,2099,2103,4,1.4,"SAMN07352199",5
"384",384,384,742,747,5,1.4,"SAMD00016397",4
"385",385,385,2099,2103,4,1.4,"SAMD00016397",5
"386",386,386,742,746,4,1.4,"SAMN04388407",4
"387",387,387,1705,1708,3,1.4,"SAMN04388407",6
"388",388,388,2098,2103,5,1.3,"SAMN04388407",5
"389",389,389,742,746,4,1.3,"SAMN07329769",4
"390",390,390,742,746,4,1.4,"SAMN05333713",4
"391",391,391,742,746,4,1.4,"SAMN07329774",4
"392",392,392,742,746,4,1.4,"SAMN03466650",4
"393",393,393,742,746,4,1.4,"SAMN03854501",4
"394",394,394,742,747,5,1.4,"SAMEA2269770",4
"395",395,395,742,747,5,1.3,"SAMEA2269859",4
"396",396,396,2099,2103,4,1.3,"SAMEA104210820",5
"397",397,397,3288,3290,2,1.7,"SAMEA104210820",3
"398",398,398,3288,3290,2,2,"SAMEA751143",3
"399",399,399,3288,3290,2,1.8,"SAMEA41258668",3
"400",400,400,1705,1708,3,1.3,"SAMEA41189668",6
"401",401,401,3288,3289,1,1.8,"SAMEA41189668",3
"402",402,402,3288,3290,2,1.5,"SAMN08443782",3
"403",403,403,3288,3290,2,2,"SAMEA751516",3
"404",404,404,3288,3290,2,1.9,"SAMN06007543",3
"405",405,405,3288,3290,2,1.9,"SAMN03464282",3
"406",406,406,3288,3290,2,2,"SAMEA751511",3
"407",407,407,3288,3290,2,1.9,"SAMN07352191",3
"408",408,408,3288,3290,2,1.8,"SAMN06140504",3
"409",409,409,3288,3290,2,1.8,"SAMEA41260168",3
"410",410,410,742,747,5,1.3,"SAMN07329789",4
"411",411,411,1705,1708,3,1.3,"SAMN07329789",6
"412",412,412,3288,3290,2,1.8,"SAMN07329789",3
"413",413,413,742,746,4,1.3,"SAMEA41197918",4
"414",414,414,1705,1708,3,1.3,"SAMEA41197918",6
"415",415,415,3288,3290,2,1.8,"SAMEA41197918",3
"416",416,416,742,747,5,1.3,"SAMEA2060466",4
"417",417,417,3288,3291,3,1.7,"SAMEA2060466",3
"418",418,418,742,747,5,1.3,"SAMEA1920853",4
"419",419,419,3288,3290,2,1.8,"SAMEA1920853",3
"420",420,420,742,747,5,1.3,"SAMEA41191168",4
"421",421,421,3288,3290,2,1.8,"SAMEA41191168",3
"422",422,422,742,746,4,1.3,"SAMEA41197168",4
"423",423,423,3288,3290,2,1.7,"SAMEA41197168",3
"424",424,424,742,746,4,1.3,"SAMN03455351",4
"425",425,425,3288,3290,2,1.9,"SAMN03455351",3
"426",426,426,742,746,4,1.3,"SAMN07329768",4
"427",427,427,3288,3290,2,1.8,"SAMN07329768",3
"428",428,428,3288,3290,2,2,"SAMEA751512",3
"429",429,429,3288,3290,2,1.9,"SAMEA41281168",3
"430",430,430,3288,3290,2,2,"SAMEA751169",3
"431",431,431,3288,3290,2,1.8,"SAMEA41280418",3
"432",432,432,3288,3290,2,1.9,"SAMEA751141",3
"433",433,433,3288,3290,2,2,"SAMEA751510",3
"434",434,434,2291,2379,88,1.4,"SAMEA751341",7
"435",435,435,3288,3290,2,2,"SAMEA751176",3
"436",436,436,1044,1103,59,1.7,"SAMEA751364",23
"437",437,437,3627,3663,36,1.3,"SAMEA751364",16
"438",438,438,2875,2917,42,1.6,"SAMEA41326168",17
"439",439,439,1534,1546,12,1.9,"SAMEA41320918",37
"440",440,440,3288,3290,2,1.8,"SAMEA41320918",3
"441",441,441,19,20,1,1.5,"SAMEA41207668",1
"442",442,442,650,661,11,1.3,"SAMEA41207668",9
"443",443,443,3044,3046,2,1.3,"SAMEA41207668",38
"444",444,444,3288,3290,2,1.6,"SAMEA41207668",3
"445",445,445,3535,3539,4,1.3,"SAMEA41207668",2
"446",446,446,3288,3290,2,1.8,"SAMEA41239918",3
"447",447,447,3285,3291,6,1.4,"SAMEA41264668",3
"448",448,448,742,745,3,1.4,"SAMN02263942",4
"449",449,449,2099,2103,4,1.3,"SAMN02263942",5
"450",450,450,3288,3291,3,1.6,"SAMN02263942",3
"451",451,451,3288,3290,2,2,"SAMEA751480",3
"452",452,452,3288,3290,2,2.1,"SAMEA1570036",3
"453",453,453,61,69,8,1.3,"SAMN03996251",19
"454",454,454,742,747,5,1.4,"SAMN03996251",4
"455",455,455,2099,2103,4,1.4,"SAMN03996251",5
"456",456,456,2925,2936,11,2.9,"SAMN03996251",17
"457",457,457,2144,2198,54,1.8,"SAMEA41246668",7
"458",458,458,2104,2379,275,1.3,"SAMEA751270",7
"459",459,459,2105,2363,258,1.4,"SAMEA751411",7
"460",460,460,3288,3290,2,2,"SAMEA751476",3
"461",461,461,3288,3290,2,2.1,"SAMEA751475",3
"462",462,462,3288,3290,2,2,"SAMEA751430",3
"463",463,463,3288,3290,2,1.8,"SAMEA41268418",3
"464",464,464,742,747,5,1.3,"SAMN03702687",4
"465",465,465,1705,1708,3,1.3,"SAMN03702687",6
"466",466,466,2099,2103,4,1.4,"SAMN03702687",5
"467",467,467,3288,3290,2,1.8,"SAMN03702687",3
"468",468,468,742,746,4,1.4,"SAMN03702645",4
"469",469,469,2100,2103,3,1.4,"SAMN03702645",5
"470",470,470,3288,3290,2,1.8,"SAMN03702645",3
"471",471,471,3288,3290,2,2.1,"SAMEA751463",3
"472",472,472,3288,3290,2,1.9,"SAMEA41238418",3
"473",473,473,741,746,5,1.4,"SAMEA41306668",4
"474",474,474,2099,2103,4,1.4,"SAMEA41306668",5
"475",475,475,3288,3290,2,1.9,"SAMEA41306668",3
"476",476,476,1309,1343,34,1.8,"SAMEA104210865",20
"477",477,477,3288,3290,2,2,"SAMEA751156",3
"478",478,478,3288,3290,2,2,"SAMEA751131",3
"479",479,479,58,67,9,1.4,"SAMEA41302168",19
"480",480,480,648,662,14,1.3,"SAMEA41302168",9
"481",481,481,2,22,20,1.3,"SAMEA41212168",1
"482",482,482,100,105,5,1.5,"SAMEA41212168",21
"483",483,483,3288,3290,2,2,"SAMEA1032246",3
"484",484,484,3288,3290,2,1.9,"SAMEA751174",3
"485",485,485,3288,3291,3,2,"SAMEA751409",3
"486",486,486,3288,3290,2,2.1,"SAMEA751434",3
"487",487,487,3288,3290,2,2.1,"SAMEA41235418",3
"488",488,488,3376,3378,2,1.3,"SAMEA41235418",2
"489",489,489,445,468,23,1.8,"SAMEA41249668",29
"490",490,490,742,746,4,1.4,"SAMEA1931871",4
"491",491,491,1827,1830,3,1.3,"SAMEA1931871",10
"492",492,492,1832,1924,92,1.3,"SAMEA1931871",10
"493",493,493,2099,2103,4,1.4,"SAMEA1931871",5
"494",494,494,59,69,10,1.7,"SAMEA41325418",19
"495",495,495,648,661,13,1.4,"SAMEA41325418",9
"496",496,496,742,746,4,1.6,"SAMEA41325418",4
"497",497,497,1705,1708,3,1.5,"SAMEA41325418",6
"498",498,498,2099,2103,4,1.6,"SAMEA41325418",5
"499",499,499,59,68,9,1.5,"SAMEA41305168",19
"500",500,500,499,506,7,1.3,"SAMEA41305168",24
"501",501,501,644,661,17,1.3,"SAMEA41305168",9
"502",502,502,2098,2103,5,1.4,"SAMEA41305168",5
"503",503,503,3285,3290,5,1.6,"SAMEA41305168",3
"504",504,504,59,67,8,1.5,"SAMEA41304418",19
"505",505,505,737,746,9,1.3,"SAMEA41304418",4
"506",506,506,2099,2103,4,1.5,"SAMEA41304418",5
"507",507,507,3286,3290,4,1.7,"SAMEA41304418",3
"508",508,508,59,67,8,1.4,"SAMEA41296918",19
"509",509,509,742,747,5,1.4,"SAMEA41296918",4
"510",510,510,2100,2103,3,1.5,"SAMEA41296918",5
"511",511,511,3288,3290,2,1.7,"SAMEA41296918",3
"512",512,512,58,67,9,1.4,"SAMEA41300668",19
"513",513,513,2099,2103,4,1.6,"SAMEA41300668",5
"514",514,514,3288,3290,2,2,"SAMEA41300668",3
"515",515,515,59,68,9,1.5,"SAMEA41314918",19
"516",516,516,2099,2103,4,1.4,"SAMEA41314918",5
"517",517,517,3288,3290,2,1.8,"SAMEA41314918",3
"518",518,518,57,67,10,1.5,"SAMEA41301418",19
"519",519,519,742,747,5,1.4,"SAMEA41301418",4
"520",520,520,2099,2102,3,1.6,"SAMEA41301418",5
"521",521,521,58,69,11,1.4,"SAMEA41303668",19
"522",522,522,2099,2103,4,1.3,"SAMEA41303668",5
"523",523,523,3285,3291,6,1.5,"SAMEA41303668",3
"524",524,524,58,68,10,1.5,"SAMEA41317168",19
"525",525,525,2098,2104,6,1.3,"SAMEA41317168",5
"526",526,526,58,67,9,1.5,"SAMEA41305918",19
"527",527,527,2099,2103,4,1.3,"SAMEA41305918",5
"528",528,528,59,67,8,1.4,"SAMEA41315668",19
"529",529,529,2099,2102,3,1.6,"SAMEA41315668",5
"530",530,530,59,71,12,1.4,"SAMEA41323918",19
"531",531,531,58,67,9,1.4,"SAMEA41324668",19
"532",532,532,58,69,11,1.4,"SAMEA41255668",19
"533",533,533,58,67,9,1.4,"SAMEA41257918",19
"534",534,534,58,71,13,1.4,"SAMEA41256418",19
"535",535,535,60,67,7,1.4,"SAMEA41272168",19
"536",536,536,3376,3378,2,1.5,"SAMEA41212918",2
"537",537,537,3557,3561,4,1.5,"SAMEA41212918",2
"538",538,538,19,20,1,1.3,"SAMEA41218168",1
"539",539,539,140,143,3,1.3,"SAMEA41218168",27
"540",540,540,2100,2103,3,1.3,"SAMEA41218168",5
"541",541,541,2,20,18,1.2,"SAMEA41217418",1
"542",542,542,742,745,3,1.3,"SAMEA41225668",4
"543",543,543,71,78,7,1.4,"SAMN08443764",19
"544",544,544,105,107,2,1.6,"SAMN08443764",21
"545",545,545,1790,1791,1,1.5,"SAMN08443764",10
"546",546,546,1827,1828,1,1.6,"SAMN08443764",10
"547",547,547,1848,1851,3,1.6,"SAMN08443764",10
"548",548,548,2057,2059,2,1.6,"SAMN08443764",11
"549",549,549,2275,2278,3,1.8,"SAMN08443764",7
"550",550,550,3105,3106,1,1.6,"SAMN08443764",8
"551",551,551,3288,3290,2,1.5,"SAMN08443764",3
"552",552,552,3507,3514,7,1.3,"SAMN08443764",2
"553",553,553,71,78,7,1.5,"SAMN08443762",19
"554",554,554,1790,1791,1,1.5,"SAMN08443762",10
"555",555,555,1847,1851,4,1.5,"SAMN08443762",10
"556",556,556,1977,1979,2,1.5,"SAMN08443762",15
"557",557,557,71,78,7,1.5,"SAMN08443772",19
"558",558,558,213,217,4,1.7,"SAMN08443772",14
"559",559,559,1847,1851,4,1.5,"SAMN08443772",10
"560",560,560,3105,3107,2,1.7,"SAMN08443772",8
"561",561,561,3507,3514,7,1.4,"SAMN08443772",2
"562",562,562,71,78,7,1.5,"SAMN08443773",19
"563",563,563,213,217,4,1.7,"SAMN08443773",14
"564",564,564,1847,1851,4,1.5,"SAMN08443773",10
"565",565,565,3105,3107,2,1.7,"SAMN08443773",8
"566",566,566,3507,3514,7,1.4,"SAMN08443773",2
"567",567,567,3288,3290,2,1.8,"SAMEA751257",3
"568",568,568,101,105,4,1.5,"SAMEA41226418",21
"569",569,569,742,746,4,1.3,"SAMEA41226418",4
"570",570,570,3556,3561,5,1.3,"SAMEA41226418",2
"571",571,571,742,746,4,1.4,"SAMN06140506",4
"572",572,572,1705,1708,3,1.4,"SAMN06140506",6
"573",573,573,2099,2103,4,1.4,"SAMN06140506",5
"574",574,574,3384,3388,4,1.3,"SAMN06140506",2
"575",575,575,741,747,6,1.5,"SAMEA104210863",4
"576",576,576,2099,2103,4,1.5,"SAMEA104210863",5
"577",577,577,742,747,5,1.3,"SAMEA41218918",4
"578",578,578,2100,2103,3,1.3,"SAMEA41218918",5
"579",579,579,742,746,4,1.4,"SAMEA41295418",4
"580",580,580,2098,2103,5,1.4,"SAMEA41295418",5
"581",581,581,3288,3290,2,1.8,"SAMEA41295418",3
"582",582,582,742,747,5,1.3,"SAMN07329777",4
"583",583,583,2099,2103,4,1.3,"SAMN07329777",5
"584",584,584,3288,3290,2,1.8,"SAMN07329777",3
"585",585,585,2099,2103,4,1.3,"SAMEA751360",5
"586",586,586,3288,3290,2,1.8,"SAMEA751360",3
"587",587,587,742,747,5,1.3,"SAMN03249378",4
"588",588,588,1705,1708,3,1.3,"SAMN03249378",6
"589",589,589,2099,2103,4,1.3,"SAMN03249378",5
"590",590,590,3288,3290,2,1.8,"SAMN03249378",3
"591",591,591,742,747,5,1.4,"SAMN03455371",4
"592",592,592,2099,2103,4,1.4,"SAMN03455371",5
"593",593,593,3288,3290,2,1.8,"SAMN03455371",3
"594",594,594,742,747,5,1.4,"SAMN04221194",4
"595",595,595,1705,1708,3,1.4,"SAMN04221194",6
"596",596,596,2099,2103,4,1.3,"SAMN04221194",5
"597",597,597,3285,3290,5,1.5,"SAMN04221194",3
"598",598,598,3285,3290,5,1.7,"SAMEA41278168",3
"599",599,599,742,747,5,1.5,"SAMEA41302918",4
"600",600,600,2100,2103,3,1.4,"SAMEA41302918",5
"601",601,601,3285,3290,5,1.6,"SAMEA41302918",3
"602",602,602,742,746,4,1.3,"SAMEA41198668",4
"603",603,603,2100,2103,3,1.3,"SAMEA41198668",5
"604",604,604,2970,2973,3,1.4,"SAMEA41198668",17
"605",605,605,742,747,5,1.3,"SAMN07137592",4
"606",606,606,846,849,3,1.3,"SAMN07137592",13
"607",607,607,2100,2103,3,1.3,"SAMN07137592",5
"608",608,608,3557,3562,5,1.3,"SAMN07137592",2
"609",609,609,742,747,5,1.3,"SAMEA104210859",4
"610",610,610,2099,2103,4,1.3,"SAMEA104210859",5
"611",611,611,3353,3356,3,1.4,"SAMEA104210859",2
"612",612,612,258,260,2,1.4,"SAMEA41193418",39
"613",613,613,742,746,4,1.3,"SAMEA41193418",4
"614",614,614,2099,2103,4,1.3,"SAMEA41193418",5
"615",615,615,742,746,4,1.3,"SAMN07352194",4
"616",616,616,846,849,3,1.3,"SAMN07352194",13
"617",617,617,2099,2103,4,1.3,"SAMN07352194",5
"618",618,618,742,746,4,1.4,"SAMN03464280",4
"619",619,619,2099,2103,4,1.4,"SAMN03464280",5
"620",620,620,742,746,4,1.4,"SAMN07329784",4
"621",621,621,2099,2103,4,1.4,"SAMN07329784",5
"622",622,622,742,747,5,1.3,"SAMN02231523",4
"623",623,623,2099,2103,4,1.3,"SAMN02231523",5
"624",624,624,742,747,5,1.3,"SAMN03702661",4
"625",625,625,2100,2103,3,1.3,"SAMN03702661",5
"626",626,626,742,747,5,1.4,"SAMEA41195668",4
"627",627,627,2099,2103,4,1.4,"SAMEA41195668",5
"628",628,628,742,746,4,1.3,"SAMEA41202418",4
"629",629,629,2100,2103,3,1.4,"SAMEA41202418",5
"630",630,630,63,69,6,1.3,"SAMN03877216",19
"631",631,631,742,746,4,1.4,"SAMN03877216",4
"632",632,632,1705,1708,3,1.4,"SAMN03877216",6
"633",633,633,2099,2103,4,1.4,"SAMN03877216",5
"634",634,634,742,747,5,1.4,"SAMN03455341",4
"635",635,635,1705,1708,3,1.4,"SAMN03455341",6
"636",636,636,2099,2103,4,1.4,"SAMN03455341",5
"637",637,637,742,747,5,1.4,"SAMEA41203918",4
"638",638,638,1705,1708,3,1.3,"SAMEA41203918",6
"639",639,639,2099,2103,4,1.3,"SAMEA41203918",5
"640",640,640,742,746,4,1.4,"SAMN02231290",4
"641",641,641,1705,1708,3,1.4,"SAMN02231290",6
"642",642,642,2099,2103,4,1.4,"SAMN02231290",5
"643",643,643,742,747,5,1.4,"SAMN06140501",4
"644",644,644,1705,1708,3,1.4,"SAMN06140501",6
"645",645,645,2099,2103,4,1.4,"SAMN06140501",5
"646",646,646,742,747,5,1.3,"SAMN02263940",4
"647",647,647,1705,1708,3,1.4,"SAMN02263940",6
"648",648,648,2099,2103,4,1.4,"SAMN02263940",5
"649",649,649,742,747,5,1.3,"SAMEA41201668",4
"650",650,650,1705,1708,3,1.4,"SAMEA41201668",6
"651",651,651,2099,2103,4,1.3,"SAMEA41201668",5
"652",652,652,742,746,4,1.3,"SAMEA41205418",4
"653",653,653,1705,1708,3,1.3,"SAMEA41205418",6
"654",654,654,2100,2103,3,1.3,"SAMEA41205418",5
"655",655,655,742,747,5,1.3,"SAMEA41204668",4
"656",656,656,1705,1708,3,1.3,"SAMEA41204668",6
"657",657,657,2100,2103,3,1.4,"SAMEA41204668",5
"658",658,658,742,747,5,1.3,"SAMN03702688",4
"659",659,659,1705,1708,3,1.3,"SAMN03702688",6
"660",660,660,2100,2103,3,1.3,"SAMN03702688",5
"661",661,661,742,747,5,1.3,"SAMEA41185918",4
"662",662,662,1705,1708,3,1.3,"SAMEA41185918",6
"663",663,663,2100,2103,3,1.3,"SAMEA41185918",5
"664",664,664,742,747,5,1.4,"SAMN05770316",4
"665",665,665,1705,1708,3,1.3,"SAMN05770316",6
"666",666,666,2098,2103,5,1.3,"SAMN05770316",5
"667",667,667,3384,3388,4,1.3,"SAMN05770316",2
"668",668,668,742,746,4,1.4,"SAMN07329772",4
"669",669,669,1705,1708,3,1.4,"SAMN07329772",6
"670",670,670,2100,2103,3,1.4,"SAMN07329772",5
"671",671,671,742,746,4,1.3,"SAMN02231457",4
"672",672,672,1705,1708,3,1.3,"SAMN02231457",6
"673",673,673,2099,2103,4,1.4,"SAMN02231457",5
"674",674,674,742,746,4,1.4,"SAMN02263932",4
"675",675,675,1705,1708,3,1.4,"SAMN02263932",6
"676",676,676,2099,2103,4,1.4,"SAMN02263932",5
"677",677,677,742,746,4,1.5,"SAMN07329792",4
"678",678,678,1705,1708,3,1.4,"SAMN07329792",6
"679",679,679,2099,2103,4,1.5,"SAMN07329792",5
"680",680,680,742,747,5,1.4,"SAMN06140507",4
"681",681,681,1705,1708,3,1.3,"SAMN06140507",6
"682",682,682,2099,2103,4,1.4,"SAMN06140507",5
"683",683,683,742,747,5,1.4,"SAMN05770315",4
"684",684,684,1705,1708,3,1.3,"SAMN05770315",6
"685",685,685,2099,2103,4,1.4,"SAMN05770315",5
"686",686,686,742,747,5,1.4,"SAMN07329794",4
"687",687,687,1705,1708,3,1.4,"SAMN07329794",6
"688",688,688,2099,2103,4,1.4,"SAMN07329794",5
"689",689,689,742,747,5,1.4,"SAMN07329783",4
"690",690,690,1705,1708,3,1.4,"SAMN07329783",6
"691",691,691,2099,2103,4,1.4,"SAMN07329783",5
"692",692,692,742,747,5,1.3,"SAMN06140508",4
"693",693,693,1705,1708,3,1.4,"SAMN06140508",6
"694",694,694,2097,2103,6,1.3,"SAMN06140508",5
"695",695,695,742,746,4,1.4,"SAMN03854500",4
"696",696,696,1705,1708,3,1.4,"SAMN03854500",6
"697",697,697,2100,2103,3,1.4,"SAMN03854500",5
"698",698,698,742,747,5,1.3,"SAMEA41192668",4
"699",699,699,1705,1708,3,1.3,"SAMEA41192668",6
"700",700,700,2100,2103,3,1.3,"SAMEA41192668",5
"701",701,701,742,746,4,1.3,"SAMEA41191918",4
"702",702,702,1705,1708,3,1.3,"SAMEA41191918",6
"703",703,703,2099,2103,4,1.3,"SAMEA41191918",5
"704",704,704,742,747,5,1.3,"SAMEA41206168",4
"705",705,705,1705,1708,3,1.3,"SAMEA41206168",6
"706",706,706,2099,2103,4,1.3,"SAMEA41206168",5
"707",707,707,742,746,4,1.4,"SAMEA41194918",4
"708",708,708,2099,2103,4,1.3,"SAMEA41194918",5
"709",709,709,742,746,4,1.4,"SAMN03702665",4
"710",710,710,2099,2103,4,1.5,"SAMN03702665",5
"711",711,711,3105,3107,2,1.4,"SAMN03702665",8
"712",712,712,742,747,5,1.4,"SAMEA41311168",4
"713",713,713,2099,2103,4,1.4,"SAMEA41311168",5
"714",714,714,742,747,5,1.4,"SAMN07329776",4
"715",715,715,2098,2103,5,1.4,"SAMN07329776",5
"716",716,716,742,747,5,1.3,"SAMEA104210864",4
"717",717,717,2098,2103,5,1.3,"SAMEA104210864",5
"718",718,718,742,747,5,1.3,"SAMEA1920866",4
"719",719,719,2099,2103,4,1.3,"SAMEA1920866",5
"720",720,720,742,746,4,1.3,"SAMEA41196418",4
"721",721,721,2099,2103,4,1.3,"SAMEA41196418",5
"722",722,722,742,746,4,1.3,"SAMN02263894",4
"723",723,723,2099,2103,4,1.4,"SAMN02263894",5
"724",724,724,742,746,4,1.4,"SAMN05908221",4
"725",725,725,2099,2103,4,1.4,"SAMN05908221",5
"726",726,726,742,746,4,1.4,"SAMN07329773",4
"727",727,727,2099,2103,4,1.4,"SAMN07329773",5
"728",728,728,742,746,4,1.4,"SAMN05908234",4
"729",729,729,2099,2103,4,1.4,"SAMN05908234",5
"730",730,730,742,747,5,1.3,"SAMEA41220418",4
"731",731,731,742,747,5,1.3,"SAMEA104210817",4
"732",732,732,2099,2103,4,1.3,"SAMEA104210817",5
"733",733,733,742,747,5,1.3,"SAMEA104210855",4
"734",734,734,742,747,5,1.3,"SAMN07329782",4
"735",735,735,1705,1708,3,1.3,"SAMN07329782",6
"736",736,736,742,747,5,1.3,"SAMEA104210843",4
"737",737,737,742,747,5,1.3,"SAMEA104210849",4
"738",738,738,742,747,5,1.3,"SAMEA41312668",4
"739",739,739,742,747,5,1.3,"SAMN03466651",4
"740",740,740,742,747,5,1.3,"SAMEA41199418",4
"741",741,741,742,746,4,1.4,"SAMN07329785",4
"742",742,742,742,746,4,1.3,"SAMEA41254168",4
"743",743,743,742,746,4,1.3,"SAMEA41209918",4
"744",744,744,742,747,5,1.3,"SAMEA41194168",4
"745",745,745,828,834,6,1.9,"SAMEA41263918",13
"746",746,746,2,31,29,1.3,"SAMEA41283418",1
"747",747,747,34,38,4,1.3,"SAMEA41283418",1
"748",748,748,2,20,18,1.3,"SAMEA41219668",1
"749",749,749,100,105,5,1.4,"SAMEA41219668",21
"750",750,750,2100,2103,3,1.3,"SAMEA41219668",5
"751",751,751,2,22,20,1.3,"SAMEA41224168",1
"752",752,752,742,746,4,1.3,"SAMEA41224168",4
"753",753,753,2,31,29,1.3,"SAMEA41224918",1
"754",754,754,2,22,20,1.3,"SAMEA41208418",1
"755",755,755,2,20,18,1.3,"SAMEA41216668",1
"756",756,756,3288,3290,2,1.9,"SAMEA41309668",3
"757",757,757,2099,2103,4,1.4,"SAMEA41296168",5
"758",758,758,3288,3290,2,1.8,"SAMEA41296168",3
"759",759,759,2099,2103,4,1.4,"SAMEA41308168",5
"760",760,760,3288,3290,2,1.8,"SAMEA41308168",3
"761",761,761,19,20,1,1.5,"SAMEA41275918",1
"762",762,762,3288,3289,1,2.2,"SAMEA41275918",3
"763",763,763,3288,3290,2,2,"SAMEA751196",3
"764",764,764,3288,3290,2,2.1,"SAMEA751444",3
"765",765,765,3288,3290,2,1.9,"SAMEA41227918",3
"766",766,766,3288,3291,3,2,"SAMEA751241",3
"767",767,767,3288,3290,2,2.2,"SAMEA751469",3
"768",768,768,3288,3290,2,1.9,"SAMEA751496",3
"769",769,769,3444,3448,4,1.4,"SAMEA751496",2
"770",770,770,649,654,5,1.3,"SAMEA41263168",9
"771",771,771,3288,3290,2,1.9,"SAMEA41263168",3
"772",772,772,3065,3067,2,1.3,"SAMEA751314",26
"773",773,773,3288,3290,2,2,"SAMEA751314",3
"774",774,774,3288,3290,2,2,"SAMEA41237668",3
"775",775,775,3376,3378,2,1.3,"SAMEA41237668",2
"776",776,776,3288,3290,2,1.9,"SAMEA751522",3
"777",777,777,3288,3290,2,1.9,"SAMEA751157",3
"778",778,778,3288,3290,2,2,"SAMEA4752847",3
"779",779,779,3288,3290,2,2,"SAMEA41239168",3
"780",780,780,3288,3290,2,2,"SAMEA751127",3
"781",781,781,3288,3290,2,2,"SAMEA751155",3
"782",782,782,59,77,18,1.3,"SAMEA41311918",19
"783",783,783,648,661,13,1.3,"SAMEA41311918",9
"784",784,784,3427,3438,11,1.3,"SAMEA41311918",2
"785",785,785,646,663,17,1.3,"SAMEA41253418",9
"786",786,786,2961,2993,32,1.3,"SAMEA41253418",17
"787",787,787,2970,2992,22,1.3,"SAMEA41313418",17
"788",788,788,653,662,9,1.3,"SAMEA1986112",9
"789",789,789,742,747,5,1.4,"SAMEA1986112",4
"790",790,790,2099,2103,4,1.5,"SAMEA1986112",5
"791",791,791,3555,3562,7,1.3,"SAMEA1986112",2
"792",792,792,653,662,9,1.3,"SAMEA1931348",9
"793",793,793,742,747,5,1.3,"SAMEA1931348",4
"794",794,794,2100,2103,3,1.4,"SAMEA1931348",5
"795",795,795,653,662,9,1.3,"SAMEA41203168",9
"796",796,796,742,747,5,1.4,"SAMEA41203168",4
"797",797,797,2099,2103,4,1.4,"SAMEA41203168",5
"798",798,798,649,661,12,1.3,"SAMEA41265418",9
"799",799,799,2098,2103,5,1.5,"SAMEA41265418",5
"800",800,800,738,746,8,1.3,"SAMEA41277418",4
"801",801,801,2099,2103,4,1.3,"SAMEA41277418",5
"802",802,802,647,653,6,1.3,"SAMEA41307418",9
"803",803,803,2099,2103,4,1.4,"SAMEA41307418",5
"804",804,804,3661,3684,23,1.3,"SAMEA41210668",16
"805",805,805,3633,3684,51,1.3,"SAMEA41211418",16
"806",806,806,150,152,2,2.1,"SAMEA41270668",40
"807",807,807,3676,3684,8,1.3,"SAMEA41271418",16
"808",808,808,742,747,5,1.3,"SAMEA751353",4
"809",809,809,1705,1708,3,1.3,"SAMEA751353",6
"810",810,810,2099,2103,4,1.3,"SAMEA751353",5
"811",811,811,2099,2103,4,1.3,"SAMEA751484",5
"812",812,812,19,20,1,1.4,"SAMEA41320168",1
"813",813,813,499,504,5,1.3,"SAMEA41320168",24
"814",814,814,19,20,1,1.5,"SAMEA104210814",1
"815",815,815,499,501,2,1.4,"SAMEA104210814",24
"816",816,816,2852,2854,2,1.4,"SAMEA104210814",17
"817",817,817,2057,2059,2,2,"SAMEA4752849",11
"818",818,818,31,34,3,1.3,"SAMN08443713",1
"819",819,819,528,531,3,1.3,"SAMN08443713",41
"820",820,820,1790,1791,1,1.4,"SAMN08443713",10
"821",821,821,1847,1851,4,1.3,"SAMN08443713",10
"822",822,822,3288,3290,2,1.4,"SAMN08443713",3
"823",823,823,275,279,4,1.4,"SAMN10525643",28
"824",824,824,3288,3291,3,1.4,"SAMN10525643",3
"825",825,825,3105,3108,3,1.3,"SAMEA104210857",8
"826",826,826,19,20,1,1.4,"SAMEA41209168",1
"827",827,827,3065,3069,4,1.3,"SAMEA41209168",26
"828",828,828,3376,3395,19,1.3,"SAMN08443712",2
"829",829,829,101,105,4,1.4,"SAMEA41221918",21
"830",830,830,134,143,9,1.2,"SAMEA41223418",27
"831",831,831,420,421,1,1.5,"SAMEA104210856",22
"832",832,832,420,421,1,1.4,"SAMEA104210831",22
"833",833,833,420,421,1,1.4,"SAMEA104210862",22
"834",834,834,2276,2277,1,1.4,"SAMN08443758",7
"835",835,835,2098,2103,5,1.4,"SAMEA41314168",5
"836",836,836,1705,1708,3,1.3,"SAMN05770313",6
"837",837,837,1705,1708,3,1.3,"SAMN07329778",6
"838",838,838,2099,2103,4,1.3,"SAMN07329778",5
"839",839,839,23,31,8,1.3,"SAMEA41230168",1
"840",840,840,16,20,4,1.3,"SAMEA41230918",1
"841",841,841,2995,3000,5,1.8,"SAMEA41262418",17
"842",842,842,58,68,10,1.6,"SAMEA41317918",19
"843",843,843,2098,2102,4,1.3,"SAMEA41317918",5
"844",844,844,58,69,11,1.4,"SAMEA41318668",19
"845",845,845,3288,3290,2,1.9,"SAMEA751125",3
"846",846,846,3288,3290,2,1.9,"SAMEA751466",3
"847",847,847,3288,3290,2,1.9,"SAMEA751162",3
"848",848,848,3288,3290,2,1.9,"SAMEA751497",3
"849",849,849,3288,3290,2,1.9,"SAMEA751448",3
"850",850,850,3288,3290,2,2,"SAMEA751477",3
"851",851,851,1966,1978,12,2.6,"SAMEA41248918",15
"852",852,852,1966,1978,12,1.9,"SAMEA41248168",15
"853",853,853,1966,1977,11,1.9,"SAMEA41259418",15
"854",854,854,213,217,4,1.7,"SAMN08443775",14
"855",855,855,1062,1065,3,2.2,"SAMN08443775",23
"856",856,856,1202,1206,4,1.8,"SAMN08443775",42
"857",857,857,1722,1723,1,2,"SAMN08443775",18
"858",858,858,1773,1777,4,2,"SAMN08443775",12
"859",859,859,1790,1790,0,2.1,"SAMN08443775",10
"860",860,860,1848,1851,3,2,"SAMN08443775",10
"861",861,861,1977,1979,2,2.1,"SAMN08443775",15
"862",862,862,2058,2059,1,2.2,"SAMN08443775",11
"863",863,863,3105,3106,1,2.1,"SAMN08443775",8
"864",864,864,1062,1065,3,2.2,"SAMN08443776",23
"865",865,865,1774,1777,3,2.1,"SAMN08443776",12
"866",866,866,1848,1851,3,2,"SAMN08443776",10
"867",867,867,1977,1979,2,2.1,"SAMN08443776",15
"868",868,868,2057,2059,2,2.1,"SAMN08443776",11
"869",869,869,3105,3107,2,2.1,"SAMN08443776",8
"870",870,870,1062,1065,3,2,"SAMN08443753",23
"871",871,871,1722,1723,1,1.8,"SAMN08443753",18
"872",872,872,1773,1777,4,1.9,"SAMN08443753",12
"873",873,873,1790,1791,1,1.8,"SAMN08443753",10
"874",874,874,1827,1828,1,2.1,"SAMN08443753",10
"875",875,875,1848,1851,3,1.8,"SAMN08443753",10
"876",876,876,1875,1877,2,2,"SAMN08443753",10
"877",877,877,1977,1979,2,2,"SAMN08443753",15
"878",878,878,2057,2059,2,2.1,"SAMN08443753",11
"879",879,879,3105,3107,2,2,"SAMN08443753",8
"880",880,880,1062,1065,3,2,"SAMN08443768",23
"881",881,881,1722,1723,1,1.8,"SAMN08443768",18
"882",882,882,1773,1777,4,1.9,"SAMN08443768",12
"883",883,883,1790,1791,1,1.8,"SAMN08443768",10
"884",884,884,1827,1828,1,2.1,"SAMN08443768",10
"885",885,885,1848,1851,3,1.8,"SAMN08443768",10
"886",886,886,1875,1877,2,2,"SAMN08443768",10
"887",887,887,1977,1979,2,2,"SAMN08443768",15
"888",888,888,2057,2059,2,2.1,"SAMN08443768",11
"889",889,889,3105,3107,2,2,"SAMN08443768",8
"890",890,890,1063,1065,2,2.1,"SAMN08443731",23
"891",891,891,1444,1447,3,1.9,"SAMN08443731",20
"892",892,892,1773,1777,4,1.8,"SAMN08443731",12
"893",893,893,1790,1790,0,1.9,"SAMN08443731",10
"894",894,894,1827,1828,1,1.9,"SAMN08443731",10
"895",895,895,1848,1851,3,1.8,"SAMN08443731",10
"896",896,896,2058,2059,1,2,"SAMN08443731",11
"897",897,897,2275,2278,3,2.1,"SAMN08443731",7
"898",898,898,3105,3106,1,1.9,"SAMN08443731",8
"899",899,899,1311,1312,1,1.9,"SAMN08443766",20
"900",900,900,1722,1723,1,1.8,"SAMN08443766",18
"901",901,901,1774,1777,3,1.7,"SAMN08443766",12
"902",902,902,1790,1790,0,1.7,"SAMN08443766",10
"903",903,903,1828,1828,0,1.8,"SAMN08443766",10
"904",904,904,1977,1979,2,1.8,"SAMN08443766",15
"905",905,905,2058,2059,1,1.9,"SAMN08443766",11
"906",906,906,2275,2277,2,2,"SAMN08443766",7
"907",907,907,3105,3106,1,1.9,"SAMN08443766",8
"908",908,908,3384,3387,3,1.6,"SAMN08443766",2
"909",909,909,1063,1065,2,1.8,"SAMN08443714",23
"910",910,910,1722,1723,1,1.8,"SAMN08443714",18
"911",911,911,1773,1777,4,1.8,"SAMN08443714",12
"912",912,912,1790,1790,0,1.9,"SAMN08443714",10
"913",913,913,3105,3107,2,1.8,"SAMN08443714",8
"914",914,914,723,726,3,1.8,"SAMN08443761",43
"915",915,915,1062,1065,3,1.8,"SAMN08443761",23
"916",916,916,1722,1723,1,1.7,"SAMN08443761",18
"917",917,917,1773,1776,3,1.7,"SAMN08443761",12
"918",918,918,1790,1790,0,1.7,"SAMN08443761",10
"919",919,919,1848,1850,2,1.7,"SAMN08443761",10
"920",920,920,1876,1877,1,1.7,"SAMN08443761",10
"921",921,921,3105,3107,2,1.8,"SAMN08443761",8
"922",922,922,785,799,14,1.6,"SAMEA751275",13
"923",923,923,1386,1403,17,1.6,"SAMEA751275",20
"924",924,924,1884,1906,22,2.4,"SAMEA751275",10
"925",925,925,1908,1941,33,2.5,"SAMEA751275",10
"926",926,926,2525,2531,6,1.7,"SAMEA751275",44
"927",927,927,1884,1941,57,2.6,"SAMEA41251918",10
"928",928,928,1084,1117,33,1.9,"SAMEA751218",23
"929",929,929,2840,2870,30,2,"SAMEA751218",17
"930",930,930,2,24,22,1.3,"SAMEA1570053",1
"931",931,931,11,24,13,1.3,"SAMEA1032218",1
"932",932,932,2988,3000,12,1.3,"SAMEA1032218",17
"933",933,933,3288,3290,2,2.6,"SAMEA1032218",3
"934",934,934,2,24,22,1.3,"SAMEA1032319",1
"935",935,935,3664,3684,20,1.3,"SAMEA1032319",16
"936",936,936,2,24,22,1.3,"SAMEA1032262",1
"937",937,937,3664,3684,20,1.3,"SAMEA1032262",16
"938",938,938,2,25,23,1.3,"SAMEA1032238",1
"939",939,939,3664,3684,20,1.3,"SAMEA1032238",16
"940",940,940,2,25,23,1.3,"SAMEA1032200",1
"941",941,941,2099,2106,7,1.3,"SAMEA1032200",5
"942",942,942,3288,3290,2,1.9,"SAMEA1032200",3
"943",943,943,2,25,23,1.3,"SAMEA1032316",1
"944",944,944,3664,3684,20,1.3,"SAMEA1032316",16
"945",945,945,2,24,22,1.3,"SAMEA1032149",1
"946",946,946,3288,3290,2,1.9,"SAMEA1032149",3
"947",947,947,2,24,22,1.3,"SAMEA1032326",1
"948",948,948,214,217,3,1.5,"SAMEA1032326",14
"949",949,949,3288,3290,2,2,"SAMEA1032326",3
"950",950,950,2,24,22,1.3,"SAMEA1032116",1
"951",951,951,58,69,11,1.5,"SAMEA1032116",19
"952",952,952,214,216,2,1.7,"SAMEA1032116",14
"953",953,953,2099,2103,4,1.4,"SAMEA1032116",5
"954",954,954,2968,2972,4,1.4,"SAMEA1032116",17
"955",955,955,2988,2994,6,1.3,"SAMEA1032116",17
"956",956,956,3288,3290,2,1.8,"SAMEA1032116",3
"957",957,957,214,216,2,1.6,"SAMEA1032236",14
"958",958,958,3664,3684,20,1.3,"SAMEA1032236",16
"959",959,959,214,216,2,1.6,"SAMEA1032154",14
"960",960,960,2,24,22,1.3,"SAMEA1032153",1
"961",961,961,2,24,22,1.3,"SAMEA1032118",1
"962",962,962,2,24,22,1.3,"SAMEA1032123",1
"963",963,963,3664,3684,20,1.3,"SAMEA1032123",16
"964",964,964,2,24,22,1.3,"SAMEA1032223",1
"965",965,965,3664,3684,20,1.3,"SAMEA1032223",16
"966",966,966,2,24,22,1.3,"SAMEA1032235",1
"967",967,967,2,25,23,1.4,"SAMEA1032277",1
"968",968,968,2,24,22,1.2,"SAMEA1032170",1
"969",969,969,2,25,23,1.3,"SAMEA1032137",1
"970",970,970,2,25,23,1.4,"SAMEA1032253",1
"971",971,971,2,25,23,1.3,"SAMEA1032163",1
"972",972,972,3664,3684,20,1.4,"SAMEA1032163",16
"973",973,973,2,25,23,1.4,"SAMEA1032145",1
"974",974,974,2,25,23,1.3,"SAMEA1032306",1
"975",975,975,2,25,23,1.3,"SAMEA1032272",1
"976",976,976,2,25,23,1.3,"SAMEA1032292",1
"977",977,977,2,25,23,1.3,"SAMEA1032308",1
"978",978,978,1729,1760,31,1.3,"SAMEA751138",25
"979",979,979,1728,1760,32,2,"SAMEA751337",25
"980",980,980,1835,1849,14,1.9,"SAMEA751337",10
